111111111111
1P01000000C1
100001101101
1000110E0101
100000000001
111111111111