111111111111
1PC1000000C1
101001101101
1010110E0101
101000000001
10100C100001
100101010001
1001000010C1
100001101101
100011000101
1C00R0010001
111111111111