1111111111111
10010000000C1
10000111110E1
1P0011E0000E1
1111111111111