111111111111111
1C000000000P101
10101000C100001
101101101011101
101C0000000C101
101011111111101
1010100C1000001
1010100100101C1
10C010100100001
1010101C100C111
101010111101C01
10101000C000101
11100E001000101
1C0000100C100C1
111111111111111