11111111111111111111111111111111111111111111111111
100000000000000000000000000000000C0000000000000001
10101111111111111111111111111111111111111111111101
1010100000000000000000000000000000000000000000C101
10101011111111111111111111111111111111111111111101
1010100000000000000000000000000000000000000000P101
10101000C11111111111111111111111111111111111111101
1010100000000000010000000000000000000C00000000C101
1010100001C01000100000000001C000000000000000000101
101010111C11101110101C1010111111111111111111111101
101C000000000000000000000000000000000000000000C101
10101111111111111111111111111111111111111111111101
1010100010001000100010001000100010000100010001C101
10100010001000100010001000100010001000010001000101
10101111111111111111111111111111111111111111111101
10101001000000000000000100000000000000000000000101
1010100010001000000001001C111110111001110000000101
1010100001C100100000100001000C101010011001110001C1
10C010000010000100C10000000111110010010010C1000101
1010100000000000111000000000000000100000101100C101
10101011111111111111111111111111101011111011111101
101010000000000000C0100000000000001000001000000101
11101001111111110010001110110111111011110000000101
1C001E000000000000000000C1000000000000000000000001
11111111111111111111111111111111111111111111111111