1111111111111111111111111111111111
1E0000000000000C00000C000000000001
0010010100100000101001000000010101
0010010010101010001001000001111111
1P0000000C00C0000000000000C1000001
1111111111111111111111111111111111