1111111111111111111111111111111111
1E0000000000000C00000C000000000111
10100101001000001010010000000001
1010010010101010001001000001111
1P0000000C00C00000000000000C1
111111111111111111111111111111